DBBBDHHHHHHHHHHHHHHHPPPPPPPPPPPPPPPPPPPDDD
DBBBDHHHHHHHHHHHHHHHDBBBBBBBBBBBBBBBBBBDDD
DBBBDPPPPPPPPPPPPPPPPPPPPBBBBBBBBBBBBBBDDD
DBBBDHHHHHHHHPHHXHHHPBBXBPPBBBBBBBBHHHHDDD
DBBBDHHHHHHHHPHHXHHHPBBXBPPBBDBBBBPHHHHDDD
DBBBDHHHHHHHHPHHHHHHPBBXBBBBBDDBBBPHHHHDDD
DBBBDHIHHHDDHHHHHHHHBBBBBBHHDDDDBPPHVHHDDD
DBBBDHHHHDDXHHHDDHHHBBBBBBBPDDDDBBBDHHHDDD
DBBBDHHHDDDDHDDDDHHHDPBBXBBBDDDDDDBDHHDDDD
PPPPPPPPPPPPPPPPPPPPPPPPPPPPPPPPPPPPPPPPPP