
A = floor.bmp
= floor.bmp
B = floor.bmp

HHHHHHHHHHHHHHHHHHHHHHHHHHHHHH  HHHHHHHH
IIIIIIIIIIIIIIIIIIIIIIIIIIIIII  IIIIIIII
JJJJJJJJJJJJJJJJJJJJJJJJJJJJJJ  JJJJJJJJ
KKKKKKKKKKKKKKKKKKKKKKKKKKKKKK  KKKKKKKK
LLLLLLLLLLLLLLLLLLLLLLLLLLLLLL  LLLLLLLL
33333333333C333333333333333333  33333333
NNNNNNNNNNBBNNNNNNNNNNNNNNNNNN  NNNNNNNN
HHHHHHHHHAAAHHHHHHHHHHHHHHHHHH  HHHHHHHH
ABCDEFGABCDEHGABCDEFGABCDEFGAB  DEFGABCD
ABCDEFGABCDEHGABCDEFGABCDEFGAB  DEFGABCD
